1111111111111111111111111111111111111111111111111111111111111111111111111111111111111111111111111111
1000000000000000000000000000000000000000000000000000000000000000000000000000000000000000000000000001
1000000000000000000000000000000000000000000000000000000000000000000000000000000000000000000000000001
1000000000000000000000000000000000000000000000000000000000000000000000000000000000000000000000000001
1000000000000000000000000000000000000000000000000000000000000000000000000000000000000000000000000001
1000002000000001111110000000000000000000001110000000000000000000000000000000000000000000000000000001
1000000000000001111110000000000000000000011111000000000000000000000000000000000000000000000000000001
1000000000000011111100000000000000000000111111100000000000000000000000000000000000000000000000000001
1000000000000001111100000000000000000001111111110000000000000000000000000000000000000000000000000001
1000000000000000000000000000000000000000111111100000000000000000000000000000000111110000000000000001
1000000000000000000000000000000000000000011110000000000000000000000000000000000111110000000000000001
1000000000000000000000000000000000000000001100000000000000000000000000000000000111110000000000000001
1000000000000000000000000000000000000000000000000000000000000000000000000000000111110000000000000001
1000000000000000000000000000000000000000000000000000000000000000000000000000000000000000000000000001
1000000000000000001111000000000000000000000000000000000000000000000000000000000000000000000000000001
1000000000000000011111000000000000000000000000000000000000000000000000000000000000000000000000000001
1000000000000000111111100000000000000000000000000000000000000000000000000000000000000000000000000001
1000000000000011111111110000000000000000000000000000000000000000000000000000000000000000000000000001
1000000000000001111111100000000000000000000000000000110000000000000000000000000000000000000000000001
1000000000000000001111100000000000000000000000000011110000000000000000000000000000000000000000000001
1000000000000000000110000000000000000000000000000011111000000000000000000000000000000000000000000001
1000000000000000000000000000000000000000000000000011111000000000000000000000000000000000000000000001
1000000000000000000000000000000000000000000000000001111000000000000000000000000000000003000000000001
1000000000000000000000000000000000000000000000000000111000000000000000000000000000000000000000000001
1000000000000000000000000000000000000000000000000000000000000000000000000000000000000000000000000001
1000000000000000000000000000000000000000000000000000000000000000000000000000000000000111100000000001
1000000000000000000000000000111100000000000000000000000000000000000000000000000000001111110000000001
1000000000000000000000000001111110000000000000000000000000000000000000000000000000000111111000000001
1000000000000000000000000001111110000000000000000000000000011000000000000000000000000111111000000001
1000000000000000000000000001111110000000000000000000000000111100000000000000000000000011110000000001
1000000000000000000000000001111100000000000000000000000001111110000000000000000000000000000000000001
1000000000000000000000000000110000000000000000000000000011111111000000000000000000000000000000000001
1000000000000000000000000000000000000000000000000000000011111111000000000000000000000000000000000001
1000000000000000000000000000000000000000000000000000000001111110000000000000000000000000000000000001
1000000000000000000000000000000000000000000000000000000000111100000000000000000000000000000000000001
1000000000000000000000000000000000000000000000000000000000011000000000000000000000000000000000000001
1000000000000000000000000000000000000000000000000000000000000000000000000000000000000000000000000001
1000000000000000011111111000000000000000000000000000000000000000000000000000000000000000000000000001
1000000000000001111111111110000000000000000000000000000000000000000000000000000000000000000000000001
1000000000000011111111111111000000000000000000000000000000000000000000000000000000000000000000000001
1000000000000011111111111111000000000000000000000000000000000000000000000000000000000000000000000001
1000000000000011111111111111000000000000000000000000000000000000000000000000000000000000000000000001
1000000000000001111111111110000000000000000000000000000000000000000000000000000000000000000000000001
1000000000000000011111111000000000000000000000000000000000000000000000000000000000111110000000000001
1000000000000000000000000000000000000000000000000000000000000000000000000000000000111111100000000001
1000000000000000000000000000000000000000000000000000000000000000000000000000000000111111100000000001
1000000000000000000000000000000000000000000000000000000000000000000000000000000000111110000000000001
1000000000000000000000000000000000000000000000000000000000000000000000000000000000111110000000000001
1000000000000000000000000000000000000000000000000000000000000000000000000000000000000000000000000001
1111111111111111111111111111111111111111111111111111111111111111111111111111111111111111111111111111